NO ./textures/test.png
SO ./textures/test.png
WE ./textures/test.png
EA ./textures/test.png

C 0,0,255
F 100,100,100

11111111111111111111111111111
11110111111111011101000010001
11000000110101011100000000001
10000100000000001100000010001
10000000000000001101011110001
1100000111010101111101100000111
1111000000000000000000000011111
111111111000000000000000000111111
        1000000000110000000000001
        1011000001110000000000001
        100100000000000S000000001
111111111011000001110000000000001
100000000011000001110111111111111
11000000110101011100000000001
11111111111111111111111111111