NO ./textures/texture_BR.png
SO ./textures/texture_BR.png
WE ./textures/texture_BR.png
EA ./texturekukykkyl

F 142,36,170
C 98,0,234

11111111111111111111
10000000000000000001
10000000000000000001
10000000000000000001
10000000000000000001
10000000000000000001
10000000000000000001
10000N00000000000001
10000000000000000001
10000000000000000001
10000000000000000001
10000000000000000001
10000000000000000001
10000000000000000001
10000000000000000001
10000000000000000001
10000000000000000001
10000000000000000001
10000000000000000001
11111111111111111111