11111111111111111111
1P1C0011111111CC0001
101C0000000000100001
10111111000011100101
10000110000001100101
10100000001100001C01
10100111101001101111
10100111000001000011
10100001C10101001001
10100000000C11011001
10110000010111001001
10011111010100001011
1C011C11110000010011
11111C00000010110011
1C001000100000110001
1C001111101000010101
10000000000000011001
10010001111000110001
100100000000011E0001
11111111111111111111